=StartupServlet

### MAIN FILE

home=HomePageServlet
homePage=homePage.jsp

blog=BlogDetailServlet
blogPage=blogDetail.jsp

search=SearchBlogServlet
searchPage=search.jsp

login=LoginServlet
loginPage=login.jsp

logout=LogoutServlet

register=CreateAccountServlet
registerPage=login.jsp

create=CreateBlogServlet
createPage=createBlog.jsp

comment=BlogCommentServlet
commentPage=commentPage.jsp

edit=BlogEditServlet
editPage=edit.jsp

notification=NotificationServlet
notificationPage=notification.jsp

rate=BlogRatingServlet

imageUpload=ImageUploadServlet

blogList=BlogListServlet
blogListPage=blogList.jsp

about=aboutUs.html

verify=AccountVerifyServlet
verifyPage=verify.jsp

profile=StudentProfileServlet
profilePage=profile.jsp

### MENTOR

mentor=MentorServlet
mentorPage=mentor.jsp

blogPendingList=MentorBlogPendingListServlet
blogPendingListPage=mentorBlogPendingList.jsp

blogPendingDetail=MentorBlogPendingDetailServlet
blogPendingDetailPage=mentorBlogPendingDetail.jsp

mentorBlogList=MentorBlogListServlet
mentorBlogListPage=mentorBlogList.jsp

award=MentorAwardServlet
awardPage=mentorAwardDetail.jsp

awardCreate=MentorCreateAwardServlet

### ADMIN

admin=AdminDashboardServlet
adminPage=admin.jsp

### admin/commentDetail=AdminCommentDetailServlet
### admin/commentDetailPage=adminCommentDetail.jsp

adminAccountCreate=AdminAccountCreateServlet
adminAccountCreatePage=adminAccountCreate.jsp

adminAccountList=AdminAccountListServlet
adminAccountListPage=adminAccountList.jsp

adminAccountDetail=AdminAccountDetailServlet
adminAccountDetailPage=adminAccountDetail.jsp

adminCategoryManage=AdminCategoryManageServlet
adminCategoryManagePage=adminCategoryManage.jsp
